map6[[
         [0,1,1,1],
         [1,1,1,1],
         [1,1,1,1],
         [1,1,1,1]
         ],
        [[0,1,1,1],
         [1,1,1,1],
         [1,1,1,1],
         [1,1,1,1]
         ],
        [[0,1,1,1],
         [1,1,1,1],
         [1,1,1,1],
         [1,1,1,1]
         ],
        [[0,1,1,1],
         [1,1,1,1],
         [1,1,1,1],
         [1,1,1,1]
         ]
        ],[ //w? start 2
        [[1,1,1,1],
         [1,1,1,1],
         [1,1,1,1],
         [1,1,1,1]
         ],
        [[1,1,1,1],
         [1,1,1,1],
         [1,1,1,1],
         [1,1,1,1]
         ],
        [[1,1,1,1],
         [1,1,1,1],
         [1,1,1,1],
         [1,1,1,1]
         ],
        [[1,1,1,1],
         [1,1,1,1],
         [1,1,1,1],
         [0,1,1,1]]
        ],[ //w? start 3
        [[1,1,1,1],
         [1,1,1,1],
         [1,1,1,1],
         [1,1,1,1]
         ],
        [[1,1,1,1],
         [1,1,1,1],
         [1,1,1,1],
         [1,1,1,1]
         ],
        [[1,1,1,1],
         [1,1,1,1],
         [1,1,1,1],
         [1,1,1,1]
         ],
        [[1,1,1,1],
         [1,1,1,1],
         [1,1,1,1],
         [0,1,1,1]
         ]
        ],[ //w? start 4
        [[0,0,0,0],
         [0,1,1,0],
         [0,1,1,0],
         [0,1,1,2]
         ],
        [[1,1,1,1],
         [1,1,1,1],
         [1,1,1,1],
         [0,1,1,1]
         ],
        [[1,1,1,1],
         [1,1,1,1],
         [1,1,1,1],
         [0,1,1,1]
         ],
        [[1,1,1,1],
         [1,1,1,1],
         [1,1,1,1],
         [0,1,1,1]
         ]
        ]
